XXXXXXXXXXXXXXXXXXX
XS  X     X       X
XXX X X XXX XXX XXX
X X X X X   X X   X
X X X XXX X X XXX X
X   X     X   X   X
X XXX XXXXX XXX X X
X X X X   X X   X X
X X X X X XXX XXX X
X X   X X     X   X
X XXX X XXXXXXX XXX
X   X X X     X   X
XXX XXX X XXXXXXX X
X X X   X         X
X X X XXXXX XXXXXXX
X   X     X X     X
X XXXXXXX X X XXX X
X         X   X  FX
XXXXXXXXXXXXXXXXXXX