XXXXXXX
XSX   X
X X X X
X   X X
XXXXX X
X    FX
XXXXXXX